        SO         ./png/test1.png
WE            ./png/test2.png
NO      ./png/test3.png


EA ./png/test4.png   
        F 125  128 53
C 1 4 5





        1111111111111111111111111
        1000000000110000000000001
        1011000001110000000000001
        1001000000000000000000001
111111111011000001110000000000001
100000000110000011101111111111111
11110111111111011100000010001
11110111111111011101010010001
11000000110101011100000010001
100000000N0000011100000010001
10000000000000001101010010001
11000001110101011111011110001
11110111 1110101 101111010001
11111111 1111111 111111111111
11               1111111






