SO ./png/test1.png
WE ./png/test2.png
NO /png/test3.png
EA ./png/test4.png
F 69 147 0
C 69 147 255



        1111111111111111111111111
        1000000000110000000000001
        1011000001110000000000001
        1001000000000000000000001
111111111011000001110000000000001
100000000010000011101011110111111
11110111111111011100000010001
11110111111111011101010010001
11000000110101011100000010001
100000000E0000011100000010001
10000000000000001101010010001
11000001110101011111011110001
11110111 1110101 101111010001
11111111 1111111 111111111111





